0000000000000000000-
0333333333333333330-
0333333333333333330-
0333333333333333330-
0333333333333333330-
0333333333333333330-
0333334444444333330-
0333334444444333330-
0333334444444333330-
0333334445444333330-
0333334444444333330-
0333334444444333330-
0333334444444333330-
0333333333333333330-
0333333333333333330-
0333333333333333330-
0333333333333333330-
0333333333333333330-
0000000000000000000